000000000000000000000000000000000000000000000000000000000000
000000000000000000000000000000000000000000000000000000000000
000000000000000000000000000000000000000000000000000000000000
000077777777777777777000000000000000000777777777777777770000
000077777777777777777000000000000000000777777777777777770000
000077777770000777000000000000000000000000777777700007770000
000077777770000777000000000000000000000000777777700007770000
777700000000000000777770000111111000077777000000000000007777
777700000000000000777770000111111000077777000000000000007777
777700000000000000777770000111111000077777000000000000007777
777700000000000000777770000111111000077777000000000000007777
777700000000000000777770000111111000077777000000000000007777
777700000000000000777771111111111111177777000000000000007777
777700000000000000777771111111111111177777000000000000007777
777700000000000000777771111111111111177777000000000000007777
777777700000000777777771111888888111177777777000000007777777
777777700000000777777771111888888111177777777000000007777777
777777700000000777777771111888888111177777777000000007777777
777777700000000777777771111888888111177777777000000007777777
777777700000000777777771111888888111177777777000000007777777
777777777777777777222222222222222222222222777777777777777777
777777777777777777222222222222222222222222777777777777777777
777777777777777777222222222222222222222222777777777777777777
777777777777777777222222222222222222222222777777777777777777
000000000000000000000000000000000000000000000000000000000000
000000000000000000000000000000000000000000000000000000000000
000000000000000000000000000000000000000000000000000000000000
000000000000000000000000000000000000000000000000000000000000
000000000000000000000000000000000000000000000000000000000000
000000000000000000000000000000000000000000000000000000000000
000000000000000000000000000000000000000000000000000000000000
000000000000000000000000000000000000000000000000000000000000
000000000000000000000000000000000000000000000000000000000000
000000000000000000000000000000000000000000000000000000000000
000000000000000000000000000000000000000000000000000000000000
000000000000000000000000000000000000000000000000000000000000
000000000000000000000000000000000000000000000000000000000000
000000000000000000000000000000000000000000000000000000000000
000000000000000000000000000000000000000000000000000000000000
000000000000000000000000000000000000000000000000000000000000
000000000000000000000000000000000000000000000000000000000000
000000000000000000000000000000000000000000000000000000000000
000000000000000000000000000000000000000000000000000000000000
000000000000000000000000000000000000000000000000000000000000
000000000000000000000000000000000000000000000000000000000000
000000000000000000000000000000000000000000000000000000000000
000000000000000000000000000000000000000000000000000000000000
000000000000000000000000000000000000000000000000000000000000
000000000000000000000000000000000000000000000000000000000000
000000000000000000000000000000000000000000000000000000000000
000000000000000000000000000000000000000000000000000000000000
000000000000000000000000000000000000000000000000000000000000
000000000000000000000000000000000000000000000000000000000000
000000000000000000000000000000000000000000000000000000000000
000000000000000000000000000000000000000000000000000000000000
000000000000000000000000007777777000000000000000000000000000
000000000000000000000000007777777000000000000000000000000000
000000000000000000000000007700077000000000000000000000000000
000000000000000000000000007700077000000000000000000000000000
000000000000000000000000007700077000000000000000000000000000