000000000000000000000000000007700000000077711100000000000000
000000000000000000000000000007700000000077711100000000000000
000000000000000000000000000007700000000077711100000000000000
000000770000008800000770000000000000000007711177000000077111
000000770000008800000770000000000000000007711177000000077111
000000770000008800000770000000000000000007711177000000077111
000000770000008800000770000000007770000007711177000000077111
000000770000008800000770000000007770000007711177000000077111
000000777700000000000777770000008880000777711100000077777111
000000777700000000000777770000008880000777711100000077777111
000000777700000000000777770000008880000777711100000077777111
000000000000000000777888000000007770000000088000000011111111
000000000000000000777888000000007770000000088000000011111111
000000000000000000777888000000007770000000088000000011111111
777777777777000000000000000011117771111000000000000077777777
777777777777000000000000000011117771111000000000000077777777
777777777777000000000000000011117771111000000000000077777777
000000000000000000000000007711110001111770000000000000000000
000000000000000000000000007711110001111770000000000000000000
000000000000000000000000007711110001111770000000000000000000
888777777777770000000077777111111111117777700000777777777888
888777777777770000000077777111111111117777700000777777777888
888777777777770000000077777111111111117777700000777777777888
888888888888880000000000000111111111110000000000777777777888
888888888888880000000000000111111111110000000000777777777888
000000000000000000000000000000011100000000000000000000000000
000000007777000000000777700000011100000000777000000000000000
000000007777000000000777700000000000000000777000000000000000
000000007777000000000777700000000000000000777000000000000000
000000007777777000000000077770000000000777777000000000000000
000000007777777000000000077770000000000777777000000000000000
000000007777777000000000000000000000000000000000000007777111
000000007777777000000000000000000000000000000000000007777111
000000000000777777000000000000000000000000000000001111111111
000000000000777777000000000000000000000000000000001111111111
000000000000000000000000000000000000000000000000001111111111
000000000000000000000000000000000000000000000000001111111111
111111100000000000000000000000000000000000000000000000000000
111111100000000000000000000000000000000000000000000000000000
222211100000000000000770000000077000000000000000000000000000
222211100000000000000077000000770000000000000000000000000000
222211100000000000000007700007700000000000000000000000000000
222211100000000000000000770077000000000000000000000000000000
222211100000000000000000077770000000000000000000000000000000
111111100000000000000000000000000000000000000000000000000000
111111100000000000000000000000000000000000000000000000000000
000000000000000000000000000000000000000000000000000000000000
000000000000000000000000000000000000000000000088000000000000
000000000000000000000000000000000000000000000088000000000000
000000000000000000000000000000000000000000000088000000000000
000000000000000000000000000000000000000000000088000000000000
000007777000000000000000000000000000000000000000000000000000
000007777000000000000000000000000000000000000000000000000000
000007777000000000000000000000000000000000000000000000000000
000007777000000000000000000000000000000000000000000000000000
000000000000000000000000007777777000000000000000000000000000
000000000000000000000000007777777000000000000000000000000000
000000000000000000000000007700077000000000000000000000000000
000000000000000000000000007700077000000000000000000000000000
000000000000000000000000007700077000000000000000000000000000






