000000000000000777000000000000000000000007770000000000000000
000000000000000777000000000000000000000007770000000000000000
000000000000000777000000000000000000000007770000000000000000
000000111111111777000000000000000000000000000000000000000000
000000111111111777000000000000000000000000000000008888888888
000000111111111777000000000000000000000000000000008888888888
777777111111111777000000000000000000000000000000000000000000
777777111111111777000000000000000000000000000000000000000000
777777111111111000000000000000000000000000000000000000000000
777777111111111000000000000000000000077770000077777777777000
111111111111111000000000000000000000077770000077777777777000
111111111111111000000000000000000000077770000077777777777000
111111111111111777777777777777777777777770000077777777777000
111111111111111777777777777777777777700000000000000007700000
111111111111111777777777777777777777700000000000000007700000
000011110000000000000000000000088888888888800000000007700000
000011110000000000000000000000088888888888800011100007700000
000011110000000000000000000000088888888888800011100007700000
000000000000000000000000000000000000000000011111111111111111
000000000000000000000000000000000000000000011111111111111111
000000000000077777000077770000000000000000011111111111111111
000000000000077777000077770000000000000000011111111111111111
000000007777777777007777777770000007777777711111111111111111
000000007777777777007777777770000007777777711111111111111111
000000000000000000007777777770000007777777711111111111111111
000000000000000000000000000000007777770000011111111111112222
000000000888000000000000000000007777770000011111111111112222
000000000888000000000000000000007777770000011111111111112222
000000000888000000000000000000007777770000011111111111112222
000000000888000000000000000000007777770000011111111111112222
000000000888000000000000000000007777770000011111111111112222
000000000000000000000000000000007777770000011111111111112222
777777000000000000000000000000000000000000000000000000000000
777777000000000000000000000000000000000000000000000000000000
777777000000000000000000000000000000000000000000000000000000
777777000000000000000000000000000000000000000000000000000000
777777777777000000000000000000000000000000000888888880000000
777777777777000000000000000000000000000000000888888880000000
777777777777000000000000000000000000000000000000088880000000
777777777777000000000000000000000000000000000000088888888800
777777777777000000000000000000000000000000000000088888888800
000000777777000000000000000000000000000000000000000000000000
000000777777000000000000000000000000000000000000000000000000
000000777777000000000000000000000000000000000000000000000000
000000777777000000000000000000000000000000000000000000000000
000000777777000000000000000000000000000000000000000007777777
000000000000000000000000000000000000000000000000000007777777
000000000000000000000000000000000000000000000000000007777777
000000000000000000000000000000000000000000000000000007777777
000000000000000000000000000000000000000000001111111110000000
000000000000000000000000000000000000000000001111111110000000
000000000000000000000000000000000000000000001111111110000000
000000000000000000000000000000000000000000001111111110000000
000000000000000000000000000000000000000000001111111110000000
000000000000000000000000000000000000000000000000000007777777
000000000000000000000000007777777000000000000000000000000000
000000000000000000000000007777777000000000000000000000000000
000000000000000000000000007700077000000000000000000000000000
000000000000000000000000007700077000000000000000000000000000
000000000000000000000000007700077000000000000000000000000000